"filename", "language", "TOML", "Rust", "comment", "blank", "total"
"d:\Codefield\esp32-rust\coool\.cargo\config.toml", "TOML", 13, 0, 2, 6, 21
"d:\Codefield\esp32-rust\coool\Cargo.lock", "TOML", 1292, 0, 2, 150, 1444
"d:\Codefield\esp32-rust\coool\Cargo.toml", "TOML", 91, 0, 2, 12, 105
"d:\Codefield\esp32-rust\coool\adxl345\Cargo.toml", "TOML", 5, 0, 0, 2, 7
"d:\Codefield\esp32-rust\coool\adxl345\src\lib.rs", "Rust", 0, 12, 0, 3, 15
"d:\Codefield\esp32-rust\coool\ec800m-at\Cargo.lock", "TOML", 522, 0, 2, 66, 590
"d:\Codefield\esp32-rust\coool\ec800m-at\Cargo.toml", "TOML", 16, 0, 7, 2, 25
"d:\Codefield\esp32-rust\coool\ec800m-at\src\client.rs", "Rust", 0, 15, 0, 3, 18
"d:\Codefield\esp32-rust\coool\ec800m-at\src\digester.rs", "Rust", 0, 98, 10, 14, 122
"d:\Codefield\esp32-rust\coool\ec800m-at\src\error.rs", "Rust", 0, 17, 0, 1, 18
"d:\Codefield\esp32-rust\coool\ec800m-at\src\general\cmds.rs", "Rust", 0, 44, 4, 9, 57
"d:\Codefield\esp32-rust\coool\ec800m-at\src\general\mod.rs", "Rust", 0, 43, 0, 6, 49
"d:\Codefield\esp32-rust\coool\ec800m-at\src\general\resps.rs", "Rust", 0, 25, 2, 6, 33
"d:\Codefield\esp32-rust\coool\ec800m-at\src\general\types.rs", "Rust", 0, 6, 0, 0, 6
"d:\Codefield\esp32-rust\coool\ec800m-at\src\gnss\cmds.rs", "Rust", 0, 382, 12, 30, 424
"d:\Codefield\esp32-rust\coool\ec800m-at\src\gnss\mod.rs", "Rust", 0, 76, 0, 2, 78
"d:\Codefield\esp32-rust\coool\ec800m-at\src\gnss\resps.rs", "Rust", 0, 52, 1, 8, 61
"d:\Codefield\esp32-rust\coool\ec800m-at\src\gnss\types.rs", "Rust", 0, 47, 0, 7, 54
"d:\Codefield\esp32-rust\coool\ec800m-at\src\lib.rs", "Rust", 0, 16, 0, 4, 20
"d:\Codefield\esp32-rust\coool\ec800m-at\src\mqtt\cmds.rs", "Rust", 0, 614, 37, 44, 695
"d:\Codefield\esp32-rust\coool\ec800m-at\src\mqtt\mod.rs", "Rust", 0, 3, 0, 0, 3
"d:\Codefield\esp32-rust\coool\ec800m-at\src\mqtt\resps.rs", "Rust", 0, 0, 0, 1, 1
"d:\Codefield\esp32-rust\coool\ec800m-at\src\mqtt\types.rs", "Rust", 0, 112, 0, 18, 130
"d:\Codefield\esp32-rust\coool\ec800m-at\src\urc.rs", "Rust", 0, 140, 11, 9, 160
"d:\Codefield\esp32-rust\coool\rust-toolchain.toml", "TOML", 4, 0, 0, 2, 6
"d:\Codefield\esp32-rust\coool\shtcx\Cargo.toml", "TOML", 5, 0, 0, 2, 7
"d:\Codefield\esp32-rust\coool\shtcx\src\lib.rs", "Rust", 0, 12, 0, 3, 15
"d:\Codefield\esp32-rust\coool\src\drv\drv_at.rs", "Rust", 0, 73, 0, 13, 86
"d:\Codefield\esp32-rust\coool\src\drv\drv_gnss.rs", "Rust", 0, 47, 16, 3, 66
"d:\Codefield\esp32-rust\coool\src\drv\drv_gsensor.rs", "Rust", 0, 0, 0, 1, 1
"d:\Codefield\esp32-rust\coool\src\drv\drv_net.rs", "Rust", 0, 6, 0, 1, 7
"d:\Codefield\esp32-rust\coool\src\drv\drv_tsensor.rs", "Rust", 0, 0, 0, 1, 1
"d:\Codefield\esp32-rust\coool\src\drv\mod.rs", "Rust", 0, 7, 0, 1, 8
"d:\Codefield\esp32-rust\coool\src\main.rs", "Rust", 0, 55, 6, 9, 70
"Total", "-", 1948, 1902, 114, 439, 4403